
Dificult words 
cloth = Es un trapo, paño, o trozo de tela. 
clothes = ropas (hablamos de mucha ropa no solo una ropa sino de varias polas va con (are por que son artar) en las oraciones)
clothing = ropa (hablamos de una sola ropa o muda de ropa)

------------------------------------------------------------------------------------------------------------------------
words
another = otro otra
to = a - hacia (cuando nos desplazamos hacia algun lugar: i´m going to the downtown)
toward = hacia (se puede varia con to: she gows toward her house)
up/down = hacia arriva - hacia abajo (they go up - i go down)
across = hacia el otro lado de (he goes across the street)
into = hacia adentro (she walked into the house) - in = dentro (si pusieramos las misma oracion es camina por la casa)
get in = entra (es mar formal que todas la palabra para indicar que dentre alguien)
enter entered entered = entrar (es mas informal)
onto=hacia arriva-hacia encima(the cat jumped onto the sofa(estaba abajo y se sube al sofa))-on(si decimos que salta estaba encima)
through = a traves de (through to glass)
along = a lo largo (we walked along the beach)
bad = malo 
badly = gravemente 
most = la mayoria
confidence = confianza 
dead = muerto
heat = calor calentar
damage = dañar daño
manage = administrar
suddenly = repentinamente
slow = lento - slowly = despacio
being = ser (referirse a estar vivo y existiendo ejemplo: A nuclear war would kill millions of living beings.)
tool = instrumentos
break up = disolver - dividir 
into = dentro - en - a
onto = sobre 
mean = medio media(calculo matematico la media) significar suponer
pour = verter derramar 
pouring = torrencial 
flow = fluir flujo 
fall = otoño caer 
allow = permitir 
contain = contener
containing = contenido
yourself = tu mismo 
rubber = caucho - goma
rubbing = frotamiento
delay = retrasar - demorar - retraso - demora
nothing = nada 
amount = monto
behavior = comportamiento
statement = declaracion 
state = estado - estatal
judge = juez - juzgar
judged = jusgado
likely = probable - probablemente
happen = suceder - ocurrir - pasar
weather = clima     
refuse = reusar rechazar 
allow = permitir 
law = ley 
sale = venta
sell = vender 
cigarette  = cigarrillo 
hind = detras de un animal
back = espalda - atras(adverb)
behind = detras
title = titulo
subtitle = subtitulo
wing = ala
lot = mucho mucha
throw = lanzar 
fear = termor 
tear = lagrima (noun)
cry = llorar (verb)
either = cualquiera (cuando hablado de elegir entre dos opciones cuando hablamos de mas opsiones escogemos any de cualquiera.)
any = cualquiera
bucket = cubeta - caneca 
unpleasant = desagradable 
fright = susto
frighten = asustar
fridge = nevera
worry = preocupacion - preocuparse 
pain = dolor 
paint = pintar
painful = doloroso
might = podria 
toward = hacia
succeed = exito
achieve = lograr alcanzar conseguir

