i=irregular r=regular d=definición

difficult remember verbs

r-arrive arrived arrived = llegar
i-awake awoke awoke = despertar
r-attach attached attached = adjuntar
i-bite bit bitten = morder
r-blush blushed blushed = sonrojar

------------------------------------------------------------------------------------------------------------------------

i-abide abode abode = tolerar - habitar morar
r-absorb absorbed absorbed = absorber
r-add addded added = añadir
r-advance advanced advanced = avanzar 
r-agree agreed agreed = acordar 
r-answer answered answered = responder-contestar
r-appear appeared appeared = aparecer - parecer
i-arise arose arisen = surgir
r-answer answered answered = preguntar
r-assign assigned assigned = asignar
r-assist assisted assisted = asistir
r-attend attended attended = atender
r-award awarded awarded = otorgar
r-bake baked baked = hornear 
r-bathe bathed bathed = bañar (en un rio lago....para la ducha es shower)
d-bath' es tanto un verbo como un nombre, y significa 'lavarse', normalmente en la ducha o baño. 'Bathe' tiene el sentido de 'bañar', en una piscina, playa, río, etc. 'Bathe' posee un alto grado de formalidad y, en la mayoría de los casos, 'bath' es más común.
d-tub = tina
d-bathtub = bañera (bañera fija al piso - tian se puede transportar)
i-be was-were been = ser estar
r-bear beared beared = soportar (soportar algo fastidioso)
hold held held = sostener
r-beat beat beaten = vencer 
i-become became become = volverse - convertirse 
i-befall befell befalled = ocurrir (ocurrir algo malo)
i-begin began begun = comenzar
start = empezar para una maquina o un negocio
i-behold beheld beheld = contemplar (mirada transitiva osea que mira durante poco tiempo)
r-believe believed believed = creer 
r-belong belonged belonged = pertenecer 
r-bend bent bent = doblar
i-bet bet bet = aportar
i-bid bid bid = ofertar
i-bind bound bound = atar
r-bleed bled bled = sangrar
r-blow blew blown = soplar
blush blushed blushed = sonrojar
r-boil boiled boiled = hervir
r-broil broiled broiled = asar
r-borrow borrowed borrowed = pedir prestado
r-bother bothered bothered = molestar
r-break broke broken = romper
r-breed bred bred = criar
i-bring brought bought = llevar con el porpocito de llevar algo a alguien
i-cast cast cast = emitir molderar elenco
i-broadcast broadcast broadcast = transmitir emitir
r-broil broiled broiled = asar 
r-brown browned browned = tostar dorar 
r-brush brushed brushed = cepillar 
i-build built built = contruir
i-burn burnt burnt = quemar 
i-burst burst burst = explotar
i-buy bought bought = comprar
r-call called called = llamar
