Dificult words 
clothes = ropas (hablamos de mucha ropa no solo una ropa sino de varias polas va con (are por que son artar) en las oraciones)
clothing = ropa (hablamos de una sola ropa o muda de ropa)
cloth = Es un trapo, paño, o trozo de tela. 
pour = verter derramar 
pouring = torrencial 
rubber = caucho - goma (la diferencia entre caucho y goma es que caucho es mas fexible, el resto es igual solo varia como decir la cosas: goma de borrar - no caucho de borrar...)
rub = flotar 
bigger = mas grande - mayor
big = grande
behave = comportarse - comportar 
behavior = comportamiento - conducta 
amount = monto cantidad
mount = aumentar - montar (los niños aumentan las emociones porque se aserca la navidad - el cantante se monto en la plataforma)
count = contar - cuenta
hind = detras de un animal
back = espalda - atras(adverb)
behind = detras
------------------------------------------------------------------------------------------------------------------------
words
another = otro otra
to = a - hacia (cuando nos desplazamos hacia algun lugar: i´m going to the downtown)
toward = hacia (se puede varia con to: she gows toward her house)
up/down = hacia arriva - hacia abajo (they go up - i go down)
across = hacia el otro lado de (he goes across the street)
into = hacia adentro (she walked into the house) - in = dentro (si pusieramos las misma oracion es camina por la casa)
get in = entra (es mar formal que todas la palabra para indicar que dentre alguien)
enter entered entered = entrar (es mas informal)
onto=hacia arriva-hacia encima(the cat jumped onto the sofa(estaba abajo y se sube al sofa))-on(si decimos que salta estaba encima)
through = a traves de (through to glass)
along = a lo largo (we walked along the beach)
bad = malo 
badly = gravemente malo 
most = la mayoria
confidence = confianza 
dead = muerto
heat = calor calentar
damage = dañar daño
manage = administrar
suddenly = repentinamente
slow = lento - slowly = despacio
being = ser (referirse a estar vivo y existiendo ejemplo: A nuclear war would kill millions of living beings.)
tool = herramientas - instrumentos (en cuanto a jercer labor de reparacion..)
instrument = instrumento (instrumentos musicales)
mean = medio media(calculo matematico la media) significar suponer
break up = disolver - dividir 
flow = fluir flujo 
fall = otoño caer 
allow = permitir 
contain = contener
containing = contenido
myself = yo mismo
self = uno mismo
yourself = tu mismo 
delay = retrasar - demorar - retraso - demora
nothing = nada 
mount = monte - aumenter (aumentar emocianlamente: el niño aumeta sus experanzas por que se acerca diciembre)
statement = declaracion 
state = estado - estatal
judge = juez - juzgar
judged = jusgado
likely = probable - probablemente
happen = suceder - ocurrir - pasar
weather = clima     
refuse = reusar rechazar 
law = ley 
sale = venta
sell = vender
cigarette  = cigarrillo 
title = titulo
subtitle = subtitulo
wing = ala
lot = mucho mucha
throw = lanzar 
fear = termor 
tear = lagrima (noun)
cry = llorar (verb)
either = cualquiera (cuando hablado de elegir entre dos opciones cuando hablamos de mas opsiones escogemos any de cualquiera.)
any = cualquiera
bucket = cubeta - caneca 
unpleasant = desagradable 
fright = susto
frighten = asustar
fridge = nevera
worry = preocupacion - preocuparse 
pain = dolor 
paint = pintar
painful = doloroso
might = podria 
toward = hacia
succeed = exito
achieve = lograr alcanzar conseguir

village = pueblo lejano o poco visitado
side = lado
site = sitio - lugar
place = lugar ((site vs place)site solo se usa cuando nos referimos a un lugar en construccion o asidente... un lugar anormal!)
government = gobierno
deliver = entregar (verb)
delivery = entrega (noun)
noun = sustantivo 
kill = matar
dead = muerto
skate = patinar
snake = serpiente
skateboard = patineta
give = dar
prize = premio
essay = ensayo 
fat = gordo - grasa(noun)
inside = dentro
outside = fuera de 
with = con
without = sin
liquid = liquido
out = fuera
bike = bicicleta
bake = hornear
lake = lago
bathe = bañarse (en un rio, lago, oceano para la ducha se usa shower)
shower = duchar
quality = calidad - cualidad
bad = malo
better = mejor
bitter = amargo
butter = mantequilla
batter = masa 
suddenly = de repente 
fall = otoño(noun) caer(verb)
befall befell befallen = ocurrir - acontecer (se usa solo para algo malo que sucede a alguien)
occur = ocurrir (es mas formal que happen, y va a ocurrir en una condiciones particulares)
happen = ocurrir (se produce de un resultado de un evento realizado)
begin began begun = comenzar - empezar
start = empezar (es mas formal que begin - se una cuando es una maquina y hacer negocios)
hand = mano
hold = sostener (con las manos, brazos, ect)
cold = frio
behold = contemplar (mirada transitiva osea que mira durante poco tiempo)
gaze = mirar fijamente
see = es ver explorando el objeto
spoon = cuchara
knife = cuchillo
fork = tenedor
road = carretera
right = derecha
left = izquierda 
finger = dedos de la manos
toes = dedos de los pies
food = comida
foot = pie
leg = pierna
nail = clavo - uñas
fingernail = uñas de las manos
toesnail = uñas del pie
away = lejos
embarrassment = verguenza 
carry = llevar (llevar algo con las manos especialmente pesado, y levantado del suelo)
take = llevar (llevar a alguna persona o a un lugar algo)
apart = aparte 
hurt = herido - herir(verb)
fire = fuego (noun) - disparar (verb)
fight = combatiente - luchador
damage = dañar
heat = calor 
heart = corazon 
stone = piedra - de piedra
award = otorgar - premio(award es un premio que se da a alguien por mérito, por haber hecho algo bien. Suele ser un certificado, una placa o una medalla.)
prize = premio (Un prize, por su parte, suele ser algo que se da a alguien cuando gana una competencia, y en general es algo más tangible, como un objeto o dinero)
price = precio - pronunciacion mas alargada
words--secondVerbs
quiet = tranquilo (quiet = sonido , calm = persona , peaceful = entorno)
peace = paz
piece = pedazo
long = largo (cuando se refiere a lo largo, no importa si es de tiempo o de magnitud)
say = decir (cominicar algo ejemplo jose dijo la verdad, say la usamos solo cuando nombramos a alguien)
tell = decir contar (cominicar una oracion larga)
below = debajo (se usa cuando esta en nivel inferior ejemplo, temperatura bajo cero,por debajo del promedio..)
under = debajo (cuando decimos que hay (menos de) o algo esta debajo de un objeto)
manage = administrar - gestionar
part = parte
way = camino - forma - manera 
exchange = intercambio
behave = comportarse 
safe = seguro segura - caja fuerte 
same = mismo mism
some = algunos - algunas
save = guardar 
any = alguno - alguna - cualquiera cualquier  
strong = fuerte con respecto a la caracteristica (adjective)
shout = grito - gritar
press = presionar - pulsar (ejercer fuerza sobre un objeto)- prensa(prensa de periodico)
small = pequeño - pequeña (en cuanto al tamaño)
soft = suave
softer = mas suave 
wall = pared 
so = asi tan  
push = empujar - empuje 
which = cual cuales
with = con
watch = reloj de mano - ver 
witch = bruja (pronunciar la e wetch)
such = tan tal (va acompañado de un pronombre no de un sustantivo)  
dirty = suciedad, ensuciar 
wardrobe = guardarropas (se puede mover o sacar.... el closet no)
closet = armario (la diferencia entre closet y guardaropas es que el closet esta en un espacio en la pare o es fijo)
ward = sala (donde es peligroso o hay heridos por una accion peligrosa)
heart = corazon
hear = escuchar 
hair = cabello 
stick = palo - baston - barra
onto = sobre - encima (cuando hay movimiento y rose, el gato sube a la azotea y camina....)
on = encima, sobre (cuando hay contacto)
over = sobre - encima (Cuando esta algo por encima pero no lo toca ejemplo un avion esta encima de mi casa ejemplo de que no toca) 
refuse = rechazar - denegar reusarse 
tight = ajustado - apretado
tighten = apretar 
provide = proveer 
travel = viaje - viajar
wrong = incorrecto 
right = correcto - derecho 
cook = cocinera
chef = cocinero
amount = cantidad - ascender (cantidada por que no se puede contar) 
